NO ./path_to_the_north_texture
SO ./path_to_the_south_texture
WE ./path_to_the_west_texture
EA ./path_to_the_east_texture

F 255,100,20
C 110,255,2


     1111111111111111111111111      
     1000000000110000000000001
     1011000001110000000000001
     1001000000000000000000001
11111111101100000111000000000111
1000000000110000011101111111111111
1110111111111011100000010001
1110111111111011101010010001
1000000110101011100000010001
10000000000000001100000010101
1000000W00000000110101001001
1000001110101011111011110001
11110111 111010111011110100011
11111111 1111111111111 111111