WE ./texture/colrstone.xpm
NO ./texture/Mago_content.xpm
SO ./texture/Mago_facher.xpm
EA ./texture/eagle.xpm

F 255,179,184
C 255,251,224

1111111111111111111111111111111111111111111111111111
1111111000000000000000000000000000000000000000000001
1000000000000000000000000000000000000000000000000001
1000000000000000000000111111111111111111100000000001
1000100000001000000000000000000000000000000000000001
1000100000001011111111111111111111111111111111100001
1000100000001000000000000000000011100000000000000001
1000100000001000000000000000000001000000000000000001
1000100000001000000000000000000001000000000000000001
100000000000100000000E000000000001000000000000000001
1000000000001000000000000000000001000001111111111111
1000000000001000000000000000000001000000000000011111
1000000000001000000000000000000001000000000000000001
1000000000000000000000000000000001000000000001000001
1111111100000000001111111111111111100000000001000001
1000000000000000000000000000000000000000000001000001
1000000000000000000000000000000000000000000000000001
1111111111111111111111111111111111111111111111111111
