NO /path_to_the_north_texture.xpm
SO /path_to_the_south_texture.xpm
WE /path_to_the_west_texture.xpm
EA /path_to_the_east_texture.xpm

F 255,100,20
C 110,255,2

111111111111111111111111111111111
100110001100010000000000001111111
100000001100010000000000001111111
100000001100010000000000001111111
110111000000000000000000000000011
100000000000000001110111111111111
111100000000000000000000100011111
11011111000000S000000001001011111        
11000000000000000000000010001    
10000000000000001100000010001    
10000000000000000001010010001    
10000011101010111110111100001    
11101111111010111101111010001    
11111111111111111111111111111    