NO ./path_to_the_north_texture
SO ./path_to_the_south_texture
WE ./path_to_the_west_texture
EA ./path_to_the_east_texture

F 255,100,20
C 110,255,2

1111111111111111111111111111111111111
        1100010000110000001111111
        1011000001110000000000001
        1001000000000000000000001  
111111111100000111000000000000011
100000000011000001110111111111111
111101111111110111000000100011111
11011111111101110101001000001        
1100000011010101110E000010001   
10000000000000001100000010001    
10000000000000011101010010001   
100000111010101 1110111100001  
1110111 111010111101111010001
1111111 1111111 1111111111111