NO /path_to_the_north_texture.xpm
SO /path_to_the_south_texture.xpm
WE /path_to_the_west_texture.xpm
EA /path_to_the_east_texture.xpm

F 255,179,184
C 255,251,224

11111111111111111
10011000110001001
10000000110001001
10000000110001001
11011100000000001
10000000000000001
11110000000000001
11011111000000N01
11000000000000001
11111111111111111