NO wall_brick.xpm
SO wall_metal.xpm
WE wall_water.xpm
EA wall_wood.xpm

F 54,179,250
C 54,173,245

111111111111111111111111111111111
100110001100010000000000001111111
100000001100010000000000001111111
100000001100010000000000001111111
110111000000000000000000000000011
100000000000000001110111111111111
111100000000000000000000100011111
110111110000000000000001001011111
11000000000000000000000010001    
10000000000000001100000010001    
10000N00000000000001010010001    
10000011101010111110111100001    
11101111111010111111111010001    
111111111111111111 11111111111