NO ./path_to_the_north_texture
SO ./path_to_the_south_texture
WE ./path_to_the_west_texture
EA ./path_to_the_east_texture

F 255,100,20
C 110,255,2

        1111111111111111111111111
        1000000000110000000000001
        1011000001110000000000001
        1001000000000000000000001
111111110110000011100000000000001
100000000011000001110111111111111
111101111111110111000000100011111
11011111111101110101001000001
1100000011010101110E000010001
10000000000000001100000010001
10000000000000001101010010001
10000011101010111110111100001
1110111 1110101 1011110100001
1111111 1111111 1111111111111