NO /path_to_the_north_texture.xpm
SO /path_to_the_south_texture.xpm
WE /path_to_the_west_texture.xpm
EA /path_to_the_east_texture.xpm

F 255,100,20
C 110,255,2

111111111111111111111111111111111
100110001100010000110000001111111
10N010001100010000110000001111111
100010001100010000110000001111111
110111111100000111000000000000011
100000000011000001110111111111111
111101111111110111000000100011111
11011111111101110101001000001        
11000000110101011100000010001   
10000000000000001100000010001    
10000000000000111101010010001   
100000111010101 1110111100001  
1110111 111010111101111010001
1111111 1111111 1111111111111